"Time","Unix Time","Entry","Exit","No. of people remained","No. of people Entered","No. of People Left"
"10/25/17 9:00 AM","1508922000","0","0","0","0","0"
"10/25/17 9:01 AM","1508922060","6","0","6","6","0"
"10/25/17 9:02 AM","1508922120","19","0","19","13","0"
"10/25/17 9:03 AM","1508922180","32","0","32","13","0"
"10/25/17 9:04 AM","1508922240","54","0","54","22","0"
"10/25/17 9:05 AM","1508922300","56","0","56","2","0"
"10/25/17 9:06 AM","1508922360","63","1","62","7","1"
"10/25/17 9:07 AM","1508922420","77","2","75","14","1"
"10/25/17 9:08 AM","1508922480","86","3","83","9","1"
"10/25/17 9:09 AM","1508922540","98","4","94","12","1"
"10/25/17 9:10 AM","1508922600","113","5","108","15","1"
"10/25/17 9:11 AM","1508922660","127","5","122","14","0"
"10/25/17 9:12 AM","1508922720","137","5","132","10","0"
"10/25/17 9:13 AM","1508922780","146","5","141","9","0"
"10/25/17 9:14 AM","1508922840","153","5","148","7","0"
"10/25/17 9:15 AM","1508922900","159","5","154","6","0"
"10/25/17 9:16 AM","1508922960","174","6","168","15","1"
"10/25/17 9:17 AM","1508923020","186","10","176","12","4"
"10/25/17 9:18 AM","1508923080","190","10","180","4","0"
"10/25/17 9:19 AM","1508923140","210","11","199","20","1"
"10/25/17 9:20 AM","1508923200","225","13","212","15","2"
"10/25/17 9:21 AM","1508923260","235","13","222","10","0"
"10/25/17 9:22 AM","1508923320","246","13","233","11","0"
"10/25/17 9:23 AM","1508923380","258","14","244","12","1"
"10/25/17 9:24 AM","1508923440","264","15","249","6","1"
"10/25/17 9:25 AM","1508923500","272","16","256","8","1"
"10/25/17 9:26 AM","1508923560","283","17","266","11","1"
"10/25/17 9:27 AM","1508923620","284","17","267","1","0"
"10/25/17 9:28 AM","1508923680","291","17","274","7","0"
"10/25/17 9:29 AM","1508923740","304","21","283","13","4"
"10/25/17 9:30 AM","1508923800","315","21","294","11","0"
"10/25/17 9:31 AM","1508923860","317","21","296","2","0"
"10/25/17 9:32 AM","1508923920","322","21","301","5","0"
"10/25/17 9:33 AM","1508923980","338","25","313","16","4"
"10/25/17 9:34 AM","1508924040","348","27","321","10","2"
"10/25/17 9:35 AM","1508924100","368","31","337","20","4"
"10/25/17 9:36 AM","1508924160","378","31","347","10","0"
"10/25/17 9:37 AM","1508924220","392","32","360","14","1"
"10/25/17 9:38 AM","1508924280","396","33","363","4","1"
"10/25/17 9:39 AM","1508924340","406","33","373","10","0"
"10/25/17 9:40 AM","1508924400","412","34","378","6","1"
"10/25/17 9:41 AM","1508924460","419","36","383","7","2"
"10/25/17 9:42 AM","1508924520","432","36","396","13","0"
"10/25/17 9:43 AM","1508924580","439","36","403","7","0"
"10/25/17 9:44 AM","1508924640","449","37","412","10","1"
"10/25/17 9:45 AM","1508924700","463","38","425","14","1"
"10/25/17 9:46 AM","1508924760","472","39","433","9","1"
"10/25/17 9:47 AM","1508924820","481","39","442","9","0"
"10/25/17 9:48 AM","1508924880","496","40","456","15","1"
"10/25/17 9:49 AM","1508924940","502","41","461","6","1"
"10/25/17 9:50 AM","1508925000","513","42","471","11","1"
"10/25/17 9:51 AM","1508925060","524","46","478","11","4"
"10/25/17 9:52 AM","1508925120","531","47","484","7","1"
"10/25/17 9:53 AM","1508925180","540","50","490","9","3"
"10/25/17 9:54 AM","1508925240","552","52","500","12","2"
"10/25/17 9:55 AM","1508925300","557","54","503","5","2"
"10/25/17 9:56 AM","1508925360","569","54","515","12","0"
"10/25/17 9:57 AM","1508925420","590","59","531","21","5"
"10/25/17 9:58 AM","1508925480","598","59","539","8","0"
"10/25/17 9:59 AM","1508925540","605","59","546","7","0"
"10/25/17 10:00 AM","1508925600","612","61","551","7","2"
"10/25/17 10:01 AM","1508925660","627","61","566","15","0"
"10/25/17 10:02 AM","1508925720","632","62","570","5","1"
"10/25/17 10:03 AM","1508925780","641","64","577","9","2"
"10/25/17 10:04 AM","1508925840","650","67","583","9","3"
"10/25/17 10:05 AM","1508925900","656","67","589","6","0"
"10/25/17 10:06 AM","1508925960","662","67","595","6","0"
"10/25/17 10:07 AM","1508926020","672","67","605","10","0"
"10/25/17 10:08 AM","1508926080","679","69","610","7","2"
"10/25/17 10:09 AM","1508926140","696","75","621","17","6"
"10/25/17 10:10 AM","1508926200","711","82","629","15","7"
"10/25/17 10:11 AM","1508926260","715","84","631","4","2"
"10/25/17 10:12 AM","1508926320","722","86","636","7","2"
"10/25/17 10:13 AM","1508926380","736","88","648","14","2"
"10/25/17 10:14 AM","1508926440","740","89","651","4","1"
"10/25/17 10:15 AM","1508926500","744","90","654","4","1"
"10/25/17 10:16 AM","1508926560","749","91","658","5","1"
"10/25/17 10:17 AM","1508926620","755","93","662","6","2"
"10/25/17 10:18 AM","1508926680","768","100","668","13","7"
"10/25/17 10:19 AM","1508926740","775","100","675","7","0"
"10/25/17 10:20 AM","1508926800","786","101","685","11","1"
"10/25/17 10:21 AM","1508926860","792","102","690","6","1"
"10/25/17 10:22 AM","1508926920","796","102","694","4","0"
"10/25/17 10:23 AM","1508926980","807","102","705","11","0"
"10/25/17 10:24 AM","1508927040","813","102","711","6","0"
"10/25/17 10:25 AM","1508927100","826","108","718","13","6"
"10/25/17 10:26 AM","1508927160","831","108","723","5","0"
"10/25/17 10:27 AM","1508927220","835","108","727","4","0"
"10/25/17 10:28 AM","1508927280","840","110","730","5","2"
"10/25/17 10:29 AM","1508927340","850","112","738","10","2"
"10/25/17 10:30 AM","1508927400","855","112","743","5","0"
"10/25/17 10:31 AM","1508927460","866","113","753","11","1"
"10/25/17 10:32 AM","1508927520","868","113","755","2","0"
"10/25/17 10:33 AM","1508927580","880","114","766","12","1"
"10/25/17 10:34 AM","1508927640","887","116","771","7","2"
"10/25/17 10:35 AM","1508927700","894","120","774","7","4"
"10/25/17 10:36 AM","1508927760","898","120","778","4","0"
"10/25/17 10:37 AM","1508927820","906","121","785","8","1"
"10/25/17 10:38 AM","1508927880","913","122","791","7","1"
"10/25/17 10:39 AM","1508927940","919","124","795","6","2"
"10/25/17 10:40 AM","1508928000","927","125","802","8","1"
"10/25/17 10:41 AM","1508928060","933","127","806","6","2"
"10/25/17 10:42 AM","1508928120","945","127","818","12","0"
"10/25/17 10:43 AM","1508928180","950","129","821","5","2"
"10/25/17 10:44 AM","1508928240","961","131","830","11","2"
"10/25/17 10:45 AM","1508928300","971","132","839","10","1"
"10/25/17 10:46 AM","1508928360","979","132","847","8","0"
"10/25/17 10:47 AM","1508928420","993","137","856","14","5"
"10/25/17 10:48 AM","1508928480","998","137","861","5","0"
"10/25/17 10:49 AM","1508928540","1003","140","863","5","3"
"10/25/17 10:50 AM","1508928600","1012","140","872","9","0"
"10/25/17 10:51 AM","1508928660","1018","140","878","6","0"
"10/25/17 10:52 AM","1508928720","1030","145","885","12","5"
"10/25/17 10:53 AM","1508928780","1038","151","887","8","6"
"10/25/17 10:54 AM","1508928840","1049","152","897","11","1"
"10/25/17 10:55 AM","1508928900","1051","154","897","2","2"
"10/25/17 10:56 AM","1508928960","1060","154","906","9","0"
"10/25/17 10:57 AM","1508929020","1060","156","904","0","2"
"10/25/17 10:58 AM","1508929080","1066","156","910","6","0"
"10/25/17 10:59 AM","1508929140","1073","158","915","7","2"
"10/25/17 11:00 AM","1508929200","1082","163","919","9","5"
"10/25/17 11:01 AM","1508929260","1087","167","920","5","4"
"10/25/17 11:02 AM","1508929320","1095","170","925","8","3"
"10/25/17 11:03 AM","1508929380","1109","175","934","14","5"
"10/25/17 11:04 AM","1508929440","1116","176","940","7","1"
"10/25/17 11:05 AM","1508929500","1125","177","948","9","1"
"10/25/17 11:06 AM","1508929560","1140","178","962","15","1"
"10/25/17 11:07 AM","1508929620","1152","179","973","12","1"
"10/25/17 11:08 AM","1508929680","1160","181","979","8","2"
"10/25/17 11:09 AM","1508929740","1170","185","985","10","4"
"10/25/17 11:10 AM","1508929800","1178","185","993","8","0"
"10/25/17 11:11 AM","1508929860","1186","187","999","8","2"
"10/25/17 11:12 AM","1508929920","1205","199","1006","19","12"
"10/25/17 11:13 AM","1508929980","1218","202","1016","13","3"
"10/25/17 11:14 AM","1508930040","1241","214","1027","23","12"
"10/25/17 11:15 AM","1508930100","1268","228","1040","27","14"
"10/25/17 11:16 AM","1508930160","1276","232","1044","8","4"
"10/25/17 11:17 AM","1508930220","1286","236","1050","10","4"
"10/25/17 11:18 AM","1508930280","1308","240","1068","22","4"
"10/25/17 11:19 AM","1508930340","1318","245","1073","10","5"
"10/25/17 11:20 AM","1508930400","1329","251","1078","11","6"
"10/25/17 11:21 AM","1508930460","1335","252","1083","6","1"
"10/25/17 11:22 AM","1508930520","1346","256","1090","11","4"
"10/25/17 11:23 AM","1508930580","1368","271","1097","22","15"
"10/25/17 11:24 AM","1508930640","1381","272","1109","13","1"
"10/25/17 11:25 AM","1508930700","1393","273","1120","12","1"
"10/25/17 11:26 AM","1508930760","1414","281","1133","21","8"
"10/25/17 11:27 AM","1508930820","1435","286","1149","21","5"
"10/25/17 11:28 AM","1508930880","1443","288","1155","8","2"
"10/25/17 11:29 AM","1508930940","1454","290","1164","11","2"
"10/25/17 11:30 AM","1508931000","1467","290","1177","13","0"
"10/25/17 11:31 AM","1508931060","1472","291","1181","5","1"
"10/25/17 11:32 AM","1508931120","1487","293","1194","15","2"
"10/25/17 11:33 AM","1508931180","1492","296","1196","5","3"
"10/25/17 11:34 AM","1508931240","1512","297","1215","20","1"
"10/25/17 11:35 AM","1508931300","1528","302","1226","16","5"
"10/25/17 11:36 AM","1508931360","1545","303","1242","17","1"
"10/25/17 11:37 AM","1508931420","1554","311","1243","9","8"
"10/25/17 11:38 AM","1508931480","1568","313","1255","14","2"
"10/25/17 11:39 AM","1508931540","1576","315","1261","8","2"
"10/25/17 11:40 AM","1508931600","1588","322","1266","12","7"
"10/25/17 11:41 AM","1508931660","1599","326","1273","11","4"
"10/25/17 11:42 AM","1508931720","1609","327","1282","10","1"
"10/25/17 11:43 AM","1508931780","1625","330","1295","16","3"
"10/25/17 11:44 AM","1508931840","1645","339","1306","20","9"
"10/25/17 11:45 AM","1508931900","1654","339","1315","9","0"
"10/25/17 11:46 AM","1508931960","1660","340","1320","6","1"
"10/25/17 11:47 AM","1508932020","1673","347","1326","13","7"
"10/25/17 11:48 AM","1508932080","1683","350","1333","10","3"
"10/25/17 11:49 AM","1508932140","1700","356","1344","17","6"
"10/25/17 11:50 AM","1508932200","1719","357","1362","19","1"
"10/25/17 11:51 AM","1508932260","1725","361","1364","6","4"
"10/25/17 11:52 AM","1508932320","1746","361","1385","21","0"
"10/25/17 11:53 AM","1508932380","1760","368","1392","14","7"
"10/25/17 11:54 AM","1508932440","1773","370","1403","13","2"
"10/25/17 11:55 AM","1508932500","1793","378","1415","20","8"
"10/25/17 11:56 AM","1508932560","1802","378","1424","9","0"
"10/25/17 11:57 AM","1508932620","1825","385","1440","23","7"
"10/25/17 11:58 AM","1508932680","1837","392","1445","12","7"
"10/25/17 11:59 AM","1508932740","1850","393","1457","13","1"
"10/25/17 12:00 PM","1508932800","1865","396","1469","15","3"
"10/25/17 12:01 PM","1508932860","1891","403","1488","26","7"
"10/25/17 12:02 PM","1508932920","1908","406","1502","17","3"
"10/25/17 12:03 PM","1508932980","1939","411","1528","31","5"
"10/25/17 12:04 PM","1508933040","1959","414","1545","20","3"
"10/25/17 12:05 PM","1508933100","1979","419","1560","20","5"
"10/25/17 12:06 PM","1508933160","1994","422","1572","15","3"
"10/25/17 12:07 PM","1508933220","2007","426","1581","13","4"
"10/25/17 12:08 PM","1508933280","2020","431","1589","13","5"
"10/25/17 12:09 PM","1508933340","2054","439","1615","34","8"
"10/25/17 12:10 PM","1508933400","2060","442","1618","6","3"
"10/25/17 12:11 PM","1508933460","2073","443","1630","13","1"
"10/25/17 12:12 PM","1508933520","2091","449","1642","18","6"
"10/25/17 12:13 PM","1508933580","2110","457","1653","19","8"
"10/25/17 12:14 PM","1508933640","2129","464","1665","19","7"
"10/25/17 12:15 PM","1508933700","2143","465","1678","14","1"
"10/25/17 12:16 PM","1508933760","2157","469","1688","14","4"
"10/25/17 12:17 PM","1508933820","2172","471","1701","15","2"
"10/25/17 12:18 PM","1508933880","2195","474","1721","23","3"
"10/25/17 12:19 PM","1508933940","2211","483","1728","16","9"
"10/25/17 12:20 PM","1508934000","2224","486","1738","13","3"
"10/25/17 12:21 PM","1508934060","2243","492","1751","19","6"
"10/25/17 12:22 PM","1508934120","2260","495","1765","17","3"
"10/25/17 12:23 PM","1508934180","2279","501","1778","19","6"
"10/25/17 12:24 PM","1508934240","2307","512","1795","28","11"
"10/25/17 12:25 PM","1508934300","2332","521","1811","25","9"
"10/25/17 12:26 PM","1508934360","2360","531","1829","28","10"
"10/25/17 12:27 PM","1508934420","2374","537","1837","14","6"
"10/25/17 12:28 PM","1508934480","2393","541","1852","19","4"
"10/25/17 12:29 PM","1508934540","2408","548","1860","15","7"
"10/25/17 12:30 PM","1508934600","2424","554","1870","16","6"
"10/25/17 12:31 PM","1508934660","2444","556","1888","20","2"
"10/25/17 12:32 PM","1508934720","2457","562","1895","13","6"
"10/25/17 12:33 PM","1508934780","2472","567","1905","15","5"
"10/25/17 12:34 PM","1508934840","2490","573","1917","18","6"
"10/25/17 12:35 PM","1508934900","2498","577","1921","8","4"
"10/25/17 12:36 PM","1508934960","2514","584","1930","16","7"
"10/25/17 12:37 PM","1508935020","2524","587","1937","10","3"
"10/25/17 12:38 PM","1508935080","2546","593","1953","22","6"
"10/25/17 12:39 PM","1508935140","2560","599","1961","14","6"
"10/25/17 12:40 PM","1508935200","2569","600","1969","9","1"
"10/25/17 12:41 PM","1508935260","2589","606","1983","20","6"
"10/25/17 12:42 PM","1508935320","2608","610","1998","19","4"
"10/25/17 12:43 PM","1508935380","2625","617","2008","17","7"
"10/25/17 12:44 PM","1508935440","2631","618","2013","6","1"
"10/25/17 12:45 PM","1508935500","2643","623","2020","12","5"
"10/25/17 12:46 PM","1508935560","2654","623","2031","11","0"
"10/25/17 12:47 PM","1508935620","2667","628","2039","13","5"
"10/25/17 12:48 PM","1508935680","2692","646","2046","25","18"
"10/25/17 12:49 PM","1508935740","2702","654","2048","10","8"
"10/25/17 12:50 PM","1508935800","2716","657","2059","14","3"
"10/25/17 12:51 PM","1508935860","2731","661","2070","15","4"
"10/25/17 12:52 PM","1508935920","2743","669","2074","12","8"
"10/25/17 12:53 PM","1508935980","2757","675","2082","14","6"
"10/25/17 12:54 PM","1508936040","2782","682","2100","25","7"
"10/25/17 12:55 PM","1508936100","2799","683","2116","17","1"
"10/25/17 12:56 PM","1508936160","2812","688","2124","13","5"
"10/25/17 12:57 PM","1508936220","2821","693","2128","9","5"
"10/25/17 12:58 PM","1508936280","2847","701","2146","26","8"
"10/25/17 12:59 PM","1508936340","2857","705","2152","10","4"
"10/25/17 1:00 PM","1508936400","2873","711","2162","16","6"
"10/25/17 1:01 PM","1508936460","2883","717","2166","10","6"
"10/25/17 1:02 PM","1508936520","2899","721","2178","16","4"
"10/25/17 1:03 PM","1508936580","2909","721","2188","10","0"
"10/25/17 1:04 PM","1508936640","2917","721","2196","8","0"
"10/25/17 1:05 PM","1508936700","2930","724","2206","13","3"
"10/25/17 1:06 PM","1508936760","2943","729","2214","13","5"
"10/25/17 1:07 PM","1508936820","2955","730","2225","12","1"
"10/25/17 1:08 PM","1508936880","2969","735","2234","14","5"
"10/25/17 1:09 PM","1508936940","2990","743","2247","21","8"
"10/25/17 1:10 PM","1508937000","2995","743","2252","5","0"
"10/25/17 1:11 PM","1508937060","3008","750","2258","13","7"
"10/25/17 1:12 PM","1508937120","3015","754","2261","7","4"
"10/25/17 1:13 PM","1508937180","3027","759","2268","12","5"
"10/25/17 1:14 PM","1508937240","3045","765","2280","18","6"
"10/25/17 1:15 PM","1508937300","3046","766","2280","1","1"
"10/25/17 1:16 PM","1508937360","3066","775","2291","20","9"
"10/25/17 1:17 PM","1508937420","3077","782","2295","11","7"
"10/25/17 1:18 PM","1508937480","3091","791","2300","14","9"
"10/25/17 1:19 PM","1508937540","3118","799","2319","27","8"
"10/25/17 1:20 PM","1508937600","3128","800","2328","10","1"
"10/25/17 1:21 PM","1508937660","3139","805","2334","11","5"
"10/25/17 1:22 PM","1508937720","3145","807","2338","6","2"
"10/25/17 1:23 PM","1508937780","3156","812","2344","11","5"
"10/25/17 1:24 PM","1508937840","3164","813","2351","8","1"
"10/25/17 1:25 PM","1508937900","3174","819","2355","10","6"
"10/25/17 1:26 PM","1508937960","3188","825","2363","14","6"
"10/25/17 1:27 PM","1508938020","3200","833","2367","12","8"
"10/25/17 1:28 PM","1508938080","3215","837","2378","15","4"
"10/25/17 1:29 PM","1508938140","3230","838","2392","15","1"
"10/25/17 1:30 PM","1508938200","3246","842","2404","16","4"
"10/25/17 1:31 PM","1508938260","3266","854","2412","20","12"
"10/25/17 1:32 PM","1508938320","3285","862","2423","19","8"
"10/25/17 1:33 PM","1508938380","3293","866","2427","8","4"
"10/25/17 1:34 PM","1508938440","3312","870","2442","19","4"
"10/25/17 1:35 PM","1508938500","3324","874","2450","12","4"
"10/25/17 1:36 PM","1508938560","3342","879","2463","18","5"
"10/25/17 1:37 PM","1508938620","3349","881","2468","7","2"
"10/25/17 1:38 PM","1508938680","3362","889","2473","13","8"
"10/25/17 1:39 PM","1508938740","3381","893","2488","19","4"
"10/25/17 1:40 PM","1508938800","3406","902","2504","25","9"
"10/25/17 1:41 PM","1508938860","3413","902","2511","7","0"
"10/25/17 1:42 PM","1508938920","3418","907","2511","5","5"
"10/25/17 1:43 PM","1508938980","3431","916","2515","13","9"
"10/25/17 1:44 PM","1508939040","3446","924","2522","15","8"
"10/25/17 1:45 PM","1508939100","3455","925","2530","9","1"
"10/25/17 1:46 PM","1508939160","3471","934","2537","16","9"
"10/25/17 1:47 PM","1508939220","3493","941","2552","22","7"
"10/25/17 1:48 PM","1508939280","3503","945","2558","10","4"
"10/25/17 1:49 PM","1508939340","3519","955","2564","16","10"
"10/25/17 1:50 PM","1508939400","3537","959","2578","18","4"
"10/25/17 1:51 PM","1508939460","3548","963","2585","11","4"
"10/25/17 1:52 PM","1508939520","3563","965","2598","15","2"
"10/25/17 1:53 PM","1508939580","3580","968","2612","17","3"
"10/25/17 1:54 PM","1508939640","3589","973","2616","9","5"
"10/25/17 1:55 PM","1508939700","3597","977","2620","8","4"
"10/25/17 1:56 PM","1508939760","3608","980","2628","11","3"
"10/25/17 1:57 PM","1508939820","3620","985","2635","12","5"
"10/25/17 1:58 PM","1508939880","3633","993","2640","13","8"
"10/25/17 1:59 PM","1508939940","3640","994","2646","7","1"
"10/25/17 2:00 PM","1508940000","3660","1003","2657","20","9"
"10/25/17 2:01 PM","1508940060","3674","1005","2669","14","2"
"10/25/17 2:02 PM","1508940120","3683","1008","2675","9","3"
"10/25/17 2:03 PM","1508940180","3696","1011","2685","13","3"
"10/25/17 2:04 PM","1508940240","3712","1017","2695","16","6"
"10/25/17 2:05 PM","1508940300","3725","1022","2703","13","5"
"10/25/17 2:06 PM","1508940360","3735","1023","2712","10","1"
"10/25/17 2:07 PM","1508940420","3742","1025","2717","7","2"
"10/25/17 2:08 PM","1508940480","3748","1028","2720","6","3"
"10/25/17 2:09 PM","1508940540","3758","1032","2726","10","4"
"10/25/17 2:10 PM","1508940600","3763","1036","2727","5","4"
"10/25/17 2:11 PM","1508940660","3771","1041","2730","8","5"
"10/25/17 2:12 PM","1508940720","3780","1043","2737","9","2"
"10/25/17 2:13 PM","1508940780","3797","1054","2743","17","11"
"10/25/17 2:14 PM","1508940840","3813","1061","2752","16","7"
"10/25/17 2:15 PM","1508940900","3830","1071","2759","17","10"
"10/25/17 2:16 PM","1508940960","3842","1071","2771","12","0"
"10/25/17 2:17 PM","1508941020","3851","1077","2774","9","6"
"10/25/17 2:18 PM","1508941080","3864","1080","2784","13","3"
"10/25/17 2:19 PM","1508941140","3880","1081","2799","16","1"
"10/25/17 2:20 PM","1508941200","3896","1087","2809","16","6"
"10/25/17 2:21 PM","1508941260","3924","1098","2826","28","11"
"10/25/17 2:22 PM","1508941320","3943","1103","2840","19","5"
"10/25/17 2:23 PM","1508941380","3949","1106","2843","6","3"
"10/25/17 2:24 PM","1508941440","3959","1110","2849","10","4"
"10/25/17 2:25 PM","1508941500","3969","1113","2856","10","3"
"10/25/17 2:26 PM","1508941560","3980","1116","2864","11","3"
"10/25/17 2:27 PM","1508941620","3992","1118","2874","12","2"
"10/25/17 2:28 PM","1508941680","4005","1122","2883","13","4"
"10/25/17 2:29 PM","1508941740","4009","1122","2887","4","0"
"10/25/17 2:30 PM","1508941800","4031","1127","2904","22","5"
"10/25/17 2:31 PM","1508941860","4045","1129","2916","14","2"
"10/25/17 2:32 PM","1508941920","4058","1134","2924","13","5"
"10/25/17 2:33 PM","1508941980","4071","1135","2936","13","1"
"10/25/17 2:34 PM","1508942040","4088","1148","2940","17","13"
"10/25/17 2:35 PM","1508942100","4100","1151","2949","12","3"
"10/25/17 2:36 PM","1508942160","4108","1155","2953","8","4"
"10/25/17 2:37 PM","1508942220","4120","1159","2961","12","4"
"10/25/17 2:38 PM","1508942280","4128","1160","2968","8","1"
"10/25/17 2:39 PM","1508942340","4141","1167","2974","13","7"
"10/25/17 2:40 PM","1508942400","4150","1174","2976","9","7"
"10/25/17 2:41 PM","1508942460","4159","1176","2983","9","2"
"10/25/17 2:42 PM","1508942520","4169","1186","2983","10","10"
"10/25/17 2:43 PM","1508942580","4184","1191","2993","15","5"
"10/25/17 2:44 PM","1508942640","4204","1199","3005","20","8"
"10/25/17 2:45 PM","1508942700","4219","1201","3018","15","2"
"10/25/17 2:46 PM","1508942760","4226","1204","3022","7","3"
"10/25/17 2:47 PM","1508942820","4247","1216","3031","21","12"
"10/25/17 2:48 PM","1508942880","4258","1219","3039","11","3"
"10/25/17 2:49 PM","1508942940","4271","1222","3049","13","3"
"10/25/17 2:50 PM","1508943000","4286","1225","3061","15","3"
"10/25/17 2:51 PM","1508943060","4306","1231","3075","20","6"
"10/25/17 2:52 PM","1508943120","4328","1239","3089","22","8"
"10/25/17 2:53 PM","1508943180","4354","1246","3108","26","7"
"10/25/17 2:54 PM","1508943240","4373","1258","3115","19","12"
"10/25/17 2:55 PM","1508943300","4384","1262","3122","11","4"
"10/25/17 2:56 PM","1508943360","4398","1265","3133","14","3"
"10/25/17 2:57 PM","1508943420","4412","1273","3139","14","8"
"10/25/17 2:58 PM","1508943480","4438","1284","3154","26","11"
"10/25/17 2:59 PM","1508943540","4447","1288","3159","9","4"
"10/25/17 3:00 PM","1508943600","4461","1294","3167","14","6"
"10/25/17 3:01 PM","1508943660","4479","1300","3179","18","6"
"10/25/17 3:02 PM","1508943720","4501","1309","3192","22","9"
"10/25/17 3:03 PM","1508943780","4523","1317","3206","22","8"
"10/25/17 3:04 PM","1508943840","4552","1333","3219","29","16"
"10/25/17 3:05 PM","1508943900","4568","1337","3231","16","4"
"10/25/17 3:06 PM","1508943960","4585","1344","3241","17","7"
"10/25/17 3:07 PM","1508944020","4609","1355","3254","24","11"
"10/25/17 3:08 PM","1508944080","4631","1365","3266","22","10"
"10/25/17 3:09 PM","1508944140","4658","1372","3286","27","7"
"10/25/17 3:10 PM","1508944200","4679","1376","3303","21","4"
"10/25/17 3:11 PM","1508944260","4688","1379","3309","9","3"
"10/25/17 3:12 PM","1508944320","4715","1392","3323","27","13"
"10/25/17 3:13 PM","1508944380","4736","1396","3340","21","4"
"10/25/17 3:14 PM","1508944440","4764","1404","3360","28","8"
"10/25/17 3:15 PM","1508944500","4799","1418","3381","35","14"
"10/25/17 3:16 PM","1508944560","4810","1421","3389","11","3"
"10/25/17 3:17 PM","1508944620","4825","1426","3399","15","5"
"10/25/17 3:18 PM","1508944680","4845","1435","3410","20","9"
"10/25/17 3:19 PM","1508944740","4862","1438","3424","17","3"
"10/25/17 3:20 PM","1508944800","4893","1447","3446","31","9"
"10/25/17 3:21 PM","1508944860","4938","1465","3473","45","18"
"10/25/17 3:22 PM","1508944920","4972","1484","3488","34","19"
"10/25/17 3:23 PM","1508944980","4994","1490","3504","22","6"
"10/25/17 3:24 PM","1508945040","5016","1493","3523","22","3"
"10/25/17 3:25 PM","1508945100","5043","1498","3545","27","5"
"10/25/17 3:26 PM","1508945160","5056","1501","3555","13","3"
"10/25/17 3:27 PM","1508945220","5078","1504","3574","22","3"
"10/25/17 3:28 PM","1508945280","5089","1509","3580","11","5"
"10/25/17 3:29 PM","1508945340","5107","1513","3594","18","4"
"10/25/17 3:30 PM","1508945400","5122","1522","3600","15","9"
"10/25/17 3:31 PM","1508945460","5144","1534","3610","22","12"
"10/25/17 3:32 PM","1508945520","5174","1550","3624","30","16"
"10/25/17 3:33 PM","1508945580","5201","1557","3644","27","7"
"10/25/17 3:34 PM","1508945640","5221","1566","3655","20","9"
"10/25/17 3:35 PM","1508945700","5233","1568","3665","12","2"
"10/25/17 3:36 PM","1508945760","5250","1575","3675","17","7"
"10/25/17 3:37 PM","1508945820","5274","1581","3693","24","6"
"10/25/17 3:38 PM","1508945880","5300","1590","3710","26","9"
"10/25/17 3:39 PM","1508945940","5317","1599","3718","17","9"
"10/25/17 3:40 PM","1508946000","5343","1605","3738","26","6"
"10/25/17 3:41 PM","1508946060","5362","1614","3748","19","9"
"10/25/17 3:42 PM","1508946120","5372","1616","3756","10","2"
"10/25/17 3:43 PM","1508946180","5392","1622","3770","20","6"
"10/25/17 3:44 PM","1508946240","5409","1626","3783","17","4"
"10/25/17 3:45 PM","1508946300","5432","1631","3801","23","5"
"10/25/17 3:46 PM","1508946360","5444","1634","3810","12","3"
"10/25/17 3:47 PM","1508946420","5453","1637","3816","9","3"
"10/25/17 3:48 PM","1508946480","5473","1645","3828","20","8"
"10/25/17 3:49 PM","1508946540","5478","1646","3832","5","1"
"10/25/17 3:50 PM","1508946600","5489","1646","3843","11","0"
"10/25/17 3:51 PM","1508946660","5496","1647","3849","7","1"
"10/25/17 3:52 PM","1508946720","5506","1649","3857","10","2"
"10/25/17 3:53 PM","1508946780","5524","1657","3867","18","8"
"10/25/17 3:54 PM","1508946840","5540","1662","3878","16","5"
"10/25/17 3:55 PM","1508946900","5554","1667","3887","14","5"
"10/25/17 3:56 PM","1508946960","5570","1673","3897","16","6"
"10/25/17 3:57 PM","1508947020","5584","1677","3907","14","4"
"10/25/17 3:58 PM","1508947080","5588","1677","3911","4","0"
"10/25/17 3:59 PM","1508947140","5605","1682","3923","17","5"
"10/25/17 4:00 PM","1508947200","5619","1684","3935","14","2"
"10/25/17 4:01 PM","1508947260","5628","1686","3942","9","2"
"10/25/17 4:02 PM","1508947320","5645","1689","3956","17","3"
"10/25/17 4:03 PM","1508947380","5670","1693","3977","25","4"
"10/25/17 4:04 PM","1508947440","5683","1703","3980","13","10"
"10/25/17 4:05 PM","1508947500","5710","1710","4000","27","7"
"10/25/17 4:06 PM","1508947560","5728","1716","4012","18","6"
"10/25/17 4:07 PM","1508947620","5751","1727","4024","23","11"
"10/25/17 4:08 PM","1508947680","5765","1730","4035","14","3"
"10/25/17 4:09 PM","1508947740","5776","1734","4042","11","4"
"10/25/17 4:10 PM","1508947800","5806","1747","4059","30","13"
"10/25/17 4:11 PM","1508947860","5834","1757","4077","28","10"
"10/25/17 4:12 PM","1508947920","5878","1773","4105","44","16"
"10/25/17 4:13 PM","1508947980","5901","1786","4115","23","13"
"10/25/17 4:14 PM","1508948040","5926","1798","4128","25","12"
"10/25/17 4:15 PM","1508948100","5950","1806","4144","24","8"
"10/25/17 4:16 PM","1508948160","5972","1814","4158","22","8"
"10/25/17 4:17 PM","1508948220","6006","1824","4182","34","10"
"10/25/17 4:18 PM","1508948280","6015","1826","4189","9","2"
"10/25/17 4:19 PM","1508948340","6027","1834","4193","12","8"
"10/25/17 4:20 PM","1508948400","6041","1841","4200","14","7"
"10/25/17 4:21 PM","1508948460","6058","1848","4210","17","7"
"10/25/17 4:22 PM","1508948520","6079","1854","4225","21","6"
"10/25/17 4:23 PM","1508948580","6092","1857","4235","13","3"
"10/25/17 4:24 PM","1508948640","6112","1861","4251","20","4"
"10/25/17 4:25 PM","1508948700","6129","1868","4261","17","7"
"10/25/17 4:26 PM","1508948760","6135","1870","4265","6","2"
"10/25/17 4:27 PM","1508948820","6166","1883","4283","31","13"
"10/25/17 4:28 PM","1508948880","6185","1890","4295","19","7"
"10/25/17 4:29 PM","1508948940","6213","1895","4318","28","5"
"10/25/17 4:30 PM","1508949000","6235","1901","4334","22","6"
"10/25/17 4:31 PM","1508949060","6264","1908","4356","29","7"
"10/25/17 4:32 PM","1508949120","6270","1910","4360","6","2"
"10/25/17 4:33 PM","1508949180","6289","1919","4370","19","9"
"10/25/17 4:34 PM","1508949240","6309","1922","4387","20","3"
"10/25/17 4:35 PM","1508949300","6317","1927","4390","8","5"
"10/25/17 4:36 PM","1508949360","6334","1936","4398","17","9"
"10/25/17 4:37 PM","1508949420","6365","1943","4422","31","7"
"10/25/17 4:38 PM","1508949480","6376","1946","4430","11","3"
"10/25/17 4:39 PM","1508949540","6398","1950","4448","22","4"
"10/25/17 4:40 PM","1508949600","6413","1964","4449","15","14"
"10/25/17 4:41 PM","1508949660","6430","1969","4461","17","5"
"10/25/17 4:42 PM","1508949720","6443","1973","4470","13","4"
"10/25/17 4:43 PM","1508949780","6467","1984","4483","24","11"
"10/25/17 4:44 PM","1508949840","6477","1988","4489","10","4"
"10/25/17 4:45 PM","1508949900","6485","1990","4495","8","2"
"10/25/17 4:46 PM","1508949960","6493","1990","4503","8","0"
"10/25/17 4:47 PM","1508950020","6505","1999","4506","12","9"
"10/25/17 4:48 PM","1508950080","6521","2008","4513","16","9"
"10/25/17 4:49 PM","1508950140","6539","2014","4525","18","6"
"10/25/17 4:50 PM","1508950200","6560","2022","4538","21","8"
"10/25/17 4:51 PM","1508950260","6564","2023","4541","4","1"
"10/25/17 4:52 PM","1508950320","6589","2030","4559","25","7"
"10/25/17 4:53 PM","1508950380","6598","2038","4560","9","8"
"10/25/17 4:54 PM","1508950440","6608","2042","4566","10","4"
"10/25/17 4:55 PM","1508950500","6618","2047","4571","10","5"
"10/25/17 4:56 PM","1508950560","6628","2053","4575","10","6"
"10/25/17 4:57 PM","1508950620","6639","2055","4584","11","2"
"10/25/17 4:58 PM","1508950680","6660","2061","4599","21","6"
"10/25/17 4:59 PM","1508950740","6685","2063","4622","25","2"
"10/25/17 5:00 PM","1508950800","6700","2069","4631","15","6"
"10/25/17 5:01 PM","1508950860","6714","2075","4639","14","6"
"10/25/17 5:02 PM","1508950920","6732","2083","4649","18","8"
"10/25/17 5:03 PM","1508950980","6755","2090","4665","23","7"
"10/25/17 5:04 PM","1508951040","6770","2093","4677","15","3"
"10/25/17 5:05 PM","1508951100","6783","2097","4686","13","4"
"10/25/17 5:06 PM","1508951160","6798","2105","4693","15","8"
"10/25/17 5:07 PM","1508951220","6813","2116","4697","15","11"
"10/25/17 5:08 PM","1508951280","6825","2121","4704","12","5"
"10/25/17 5:09 PM","1508951340","6839","2125","4714","14","4"
"10/25/17 5:10 PM","1508951400","6850","2128","4722","11","3"
"10/25/17 5:11 PM","1508951460","6865","2133","4732","15","5"
"10/25/17 5:12 PM","1508951520","6880","2141","4739","15","8"
"10/25/17 5:13 PM","1508951580","6893","2150","4743","13","9"
"10/25/17 5:14 PM","1508951640","6905","2157","4748","12","7"
"10/25/17 5:15 PM","1508951700","6913","2161","4752","8","4"
"10/25/17 5:16 PM","1508951760","6927","2166","4761","14","5"
"10/25/17 5:17 PM","1508951820","6953","2173","4780","26","7"
"10/25/17 5:18 PM","1508951880","6971","2177","4794","18","4"
"10/25/17 5:19 PM","1508951940","6977","2177","4800","6","0"
"10/25/17 5:20 PM","1508952000","6992","2184","4808","15","7"
"10/25/17 5:21 PM","1508952060","7001","2188","4813","9","4"
"10/25/17 5:22 PM","1508952120","7021","2200","4821","20","12"
"10/25/17 5:23 PM","1508952180","7042","2206","4836","21","6"
"10/25/17 5:24 PM","1508952240","7054","2209","4845","12","3"
"10/25/17 5:25 PM","1508952300","7062","2213","4849","8","4"
"10/25/17 5:26 PM","1508952360","7075","2216","4859","13","3"
"10/25/17 5:27 PM","1508952420","7084","2220","4864","9","4"
"10/25/17 5:28 PM","1508952480","7099","2227","4872","15","7"
"10/25/17 6:00 PM","1508954400","7125","2230","4895","26","3"
"10/25/17 6:01 PM","1508954460","7149","2233","4916","24","3"
"10/25/17 6:02 PM","1508954520","7161","2234","4927","12","1"
"10/25/17 6:03 PM","1508954580","7180","2239","4941","19","5"
"10/25/17 6:04 PM","1508954640","7194","2243","4951","14","4"
"10/25/17 6:05 PM","1508954700","7216","2251","4965","22","8"
"10/25/17 6:06 PM","1508954760","7238","2263","4975","22","12"
"10/25/17 6:07 PM","1508954820","7259","2271","4988","21","8"
"10/25/17 6:08 PM","1508954880","7279","2278","5001","20","7"
"10/25/17 6:09 PM","1508954940","7297","2284","5013","18","6"
"10/25/17 6:10 PM","1508955000","7319","2286","5033","22","2"
"10/25/17 6:11 PM","1508955060","7342","2291","5051","23","5"
"10/25/17 6:12 PM","1508955120","7371","2299","5072","29","8"
"10/25/17 6:13 PM","1508955180","7384","2304","5080","13","5"
"10/25/17 6:14 PM","1508955240","7407","2310","5097","23","6"
"10/25/17 6:15 PM","1508955300","7421","2312","5109","14","2"
"10/25/17 6:16 PM","1508955360","7429","2316","5113","8","4"
"10/25/17 6:17 PM","1508955420","7441","2319","5122","12","3"
"10/25/17 6:18 PM","1508955480","7463","2321","5142","22","2"
"10/25/17 6:19 PM","1508955540","7484","2331","5153","21","10"
"10/25/17 6:20 PM","1508955600","7501","2335","5166","17","4"
"10/25/17 6:21 PM","1508955660","7526","2350","5176","25","15"
"10/25/17 6:22 PM","1508955720","7549","2366","5183","23","16"
"10/25/17 6:23 PM","1508955780","7558","2373","5185","9","7"
"10/25/17 6:24 PM","1508955840","7585","2378","5207","27","5"
"10/25/17 6:25 PM","1508955900","7605","2390","5215","20","12"
"10/25/17 6:26 PM","1508955960","7625","2403","5222","20","13"
"10/25/17 6:27 PM","1508956020","7641","2409","5232","16","6"
"10/25/17 6:28 PM","1508956080","7652","2413","5239","11","4"
"10/25/17 6:29 PM","1508956140","7687","2425","5262","35","12"
"10/25/17 6:30 PM","1508956200","7705","2428","5277","18","3"
"10/25/17 6:31 PM","1508956260","7723","2430","5293","18","2"
"10/25/17 6:32 PM","1508956320","7749","2436","5313","26","6"
"10/25/17 6:33 PM","1508956380","7787","2442","5345","38","6"
"10/25/17 6:34 PM","1508956440","7812","2445","5367","25","3"
"10/25/17 6:35 PM","1508956500","7828","2452","5376","16","7"
"10/25/17 6:36 PM","1508956560","7855","2458","5397","27","6"
"10/25/17 6:37 PM","1508956620","7878","2468","5410","23","10"
"10/25/17 6:38 PM","1508956680","7916","2473","5443","38","5"
"10/25/17 6:39 PM","1508956740","7952","2490","5462","36","17"
"10/25/17 6:40 PM","1508956800","7986","2498","5488","34","8"
"10/25/17 6:41 PM","1508956860","8021","2506","5515","35","8"
"10/25/17 6:42 PM","1508956920","8049","2513","5536","28","7"
"10/25/17 6:43 PM","1508956980","8087","2528","5559","38","15"
"10/25/17 6:44 PM","1508957040","8112","2537","5575","25","9"
"10/25/17 6:45 PM","1508957100","8146","2551","5595","34","14"
"10/25/17 6:46 PM","1508957160","8168","2559","5609","22","8"
"10/25/17 6:47 PM","1508957220","8204","2567","5637","36","8"
"10/25/17 6:48 PM","1508957280","8227","2575","5652","23","8"
"10/25/17 6:49 PM","1508957340","8270","2600","5670","43","25"
"10/25/17 6:50 PM","1508957400","8308","2625","5683","38","25"
"10/25/17 6:51 PM","1508957460","8346","2642","5704","38","17"
"10/25/17 6:52 PM","1508957520","8379","2650","5729","33","8"
"10/25/17 6:53 PM","1508957580","8410","2657","5753","31","7"
"10/25/17 6:54 PM","1508957640","8437","2666","5771","27","9"
"10/25/17 6:55 PM","1508957700","8460","2674","5786","23","8"
"10/25/17 6:56 PM","1508957760","8478","2675","5803","18","1"
"10/25/17 6:57 PM","1508957820","8495","2679","5816","17","4"
"10/25/17 6:58 PM","1508957880","8521","2685","5836","26","6"
"10/25/17 6:59 PM","1508957940","8540","2693","5847","19","8"
"10/25/17 7:00 PM","1508958000","8556","2694","5862","16","1"
"10/25/17 7:01 PM","1508958060","8579","2702","5877","23","8"
"10/25/17 7:02 PM","1508958120","8598","2709","5889","19","7"
"10/25/17 7:03 PM","1508958180","8632","2716","5916","34","7"
"10/25/17 7:04 PM","1508958240","8653","2724","5929","21","8"
"10/25/17 7:05 PM","1508958300","8692","2740","5952","39","16"
"10/25/17 7:06 PM","1508958360","8729","2761","5968","37","21"
"10/25/17 7:07 PM","1508958420","8750","2775","5975","21","14"
"10/25/17 7:08 PM","1508958480","8791","2788","6003","41","13"
"10/25/17 7:09 PM","1508958540","8811","2800","6011","20","12"
"10/25/17 7:10 PM","1508958600","8832","2807","6025","21","7"
"10/25/17 7:11 PM","1508958660","8847","2810","6037","15","3"
"10/25/17 7:12 PM","1508958720","8874","2817","6057","27","7"
"10/25/17 7:13 PM","1508958780","8904","2829","6075","30","12"
"10/25/17 7:14 PM","1508958840","8922","2840","6082","18","11"
"10/25/17 7:15 PM","1508958900","8944","2845","6099","22","5"
"10/25/17 7:16 PM","1508958960","8958","2853","6105","14","8"
"10/25/17 7:17 PM","1508959020","8969","2855","6114","11","2"
"10/25/17 7:18 PM","1508959080","8983","2857","6126","14","2"
"10/25/17 7:19 PM","1508959140","8992","2860","6132","9","3"
"10/25/17 7:20 PM","1508959200","9014","2864","6150","22","4"
"10/25/17 7:21 PM","1508959260","9026","2869","6157","12","5"
"10/25/17 7:22 PM","1508959320","9059","2888","6171","33","19"
"10/25/17 7:23 PM","1508959380","9099","2911","6188","40","23"
"10/25/17 7:24 PM","1508959440","9128","2921","6207","29","10"
"10/25/17 7:25 PM","1508959500","9149","2937","6212","21","16"
"10/25/17 7:26 PM","1508959560","9170","2943","6227","21","6"
"10/25/17 7:27 PM","1508959620","9199","2954","6245","29","11"
"10/25/17 7:28 PM","1508959680","9237","2966","6271","38","12"
"10/25/17 7:29 PM","1508959740","9276","2971","6305","39","5"
"10/25/17 7:30 PM","1508959800","9305","2982","6323","29","11"
"10/25/17 7:31 PM","1508959860","9337","2999","6338","32","17"
"10/25/17 7:32 PM","1508959920","9347","3008","6339","10","9"
"10/25/17 7:33 PM","1508959980","9361","3013","6348","14","5"
"10/25/17 7:34 PM","1508960040","9387","3021","6366","26","8"
"10/25/17 7:35 PM","1508960100","9400","3025","6375","13","4"
"10/25/17 7:36 PM","1508960160","9425","3035","6390","25","10"
"10/25/17 7:37 PM","1508960220","9435","3037","6398","10","2"
"10/25/17 7:38 PM","1508960280","9464","3050","6414","29","13"
"10/25/17 7:39 PM","1508960340","9486","3056","6430","22","6"
"10/25/17 7:40 PM","1508960400","9511","3064","6447","25","8"
"10/25/17 7:41 PM","1508960460","9521","3068","6453","10","4"
"10/25/17 7:42 PM","1508960520","9534","3075","6459","13","7"
"10/25/17 7:43 PM","1508960580","9554","3079","6475","20","4"
"10/25/17 7:44 PM","1508960640","9575","3089","6486","21","10"
"10/25/17 7:45 PM","1508960700","9588","3095","6493","13","6"
"10/25/17 7:46 PM","1508960760","9608","3099","6509","20","4"
"10/25/17 7:47 PM","1508960820","9630","3108","6522","22","9"
"10/25/17 7:48 PM","1508960880","9646","3115","6531","16","7"
"10/25/17 7:49 PM","1508960940","9672","3122","6550","26","7"
"10/25/17 7:50 PM","1508961000","9700","3137","6563","28","15"
"10/25/17 7:51 PM","1508961060","9717","3148","6569","17","11"
"10/25/17 7:52 PM","1508961120","9749","3160","6589","32","12"
"10/25/17 7:53 PM","1508961180","9757","3171","6586","8","11"
"10/25/17 7:54 PM","1508961240","9769","3174","6595","12","3"
"10/25/17 7:55 PM","1508961300","9786","3179","6607","17","5"
"10/25/17 7:56 PM","1508961360","9799","3186","6613","13","7"
"10/25/17 7:57 PM","1508961420","9829","3196","6633","30","10"
"10/25/17 7:58 PM","1508961480","9847","3207","6640","18","11"
"10/25/17 7:59 PM","1508961540","9865","3216","6649","18","9"
"10/25/17 8:00 PM","1508961600","9880","3219","6661","15","3"
"10/25/17 8:01 PM","1508961660","9897","3228","6669","17","9"
"10/25/17 8:02 PM","1508961720","9916","3230","6686","19","2"
"10/25/17 8:03 PM","1508961780","9929","3240","6689","13","10"
"10/25/17 8:04 PM","1508961840","9958","3247","6711","29","7"
"10/25/17 8:05 PM","1508961900","9987","3262","6725","29","15"
"10/25/17 8:06 PM","1508961960","10003","3267","6736","16","5"
"10/25/17 8:07 PM","1508962020","10024","3276","6748","21","9"
"10/25/17 8:08 PM","1508962080","10040","3280","6760","16","4"
"10/25/17 8:09 PM","1508962140","10057","3291","6766","17","11"
"10/25/17 8:10 PM","1508962200","10076","3296","6780","19","5"
"10/25/17 8:11 PM","1508962260","10085","3301","6784","9","5"
"10/25/17 8:12 PM","1508962320","10099","3308","6791","14","7"
"10/25/17 8:13 PM","1508962380","10111","3317","6794","12","9"
"10/25/17 8:14 PM","1508962440","10123","3321","6802","12","4"
"10/25/17 8:15 PM","1508962500","10143","3328","6815","20","7"
"10/25/17 8:16 PM","1508962560","10157","3335","6822","14","7"
"10/25/17 8:17 PM","1508962620","10172","3345","6827","15","10"
"10/25/17 8:18 PM","1508962680","10188","3352","6836","16","7"
"10/25/17 8:19 PM","1508962740","10207","3354","6853","19","2"
"10/25/17 8:20 PM","1508962800","10240","3372","6868","33","18"
"10/25/17 8:21 PM","1508962860","10257","3378","6879","17","6"
"10/25/17 8:22 PM","1508962920","10277","3385","6892","20","7"
"10/25/17 8:23 PM","1508962980","10304","3400","6904","27","15"
"10/25/17 8:24 PM","1508963040","10325","3406","6919","21","6"
"10/25/17 8:25 PM","1508963100","10341","3417","6924","16","11"
"10/25/17 8:26 PM","1508963160","10352","3423","6929","11","6"
"10/25/17 8:27 PM","1508963220","10360","3428","6932","8","5"
"10/25/17 8:28 PM","1508963280","10377","3437","6940","17","9"
"10/25/17 8:29 PM","1508963340","10392","3443","6949","15","6"
"10/25/17 8:30 PM","1508963400","10399","3447","6952","7","4"
"10/25/17 8:31 PM","1508963460","10415","3449","6966","16","2"
"10/25/17 8:32 PM","1508963520","10433","3458","6975","18","9"
"10/25/17 8:33 PM","1508963580","10446","3468","6978","13","10"
"10/25/17 8:34 PM","1508963640","10466","3481","6985","20","13"
"10/25/17 8:35 PM","1508963700","10488","3486","7002","22","5"
"10/25/17 8:36 PM","1508963760","10495","3490","7005","7","4"
"10/25/17 8:37 PM","1508963820","10506","3496","7010","11","6"
"10/25/17 8:38 PM","1508963880","10516","3500","7016","10","4"
"10/25/17 8:39 PM","1508963940","10528","3511","7017","12","11"
"10/25/17 8:40 PM","1508964000","10548","3516","7032","20","5"
"10/25/17 8:41 PM","1508964060","10563","3523","7040","15","7"
"10/25/17 8:42 PM","1508964120","10570","3527","7043","7","4"
"10/25/17 8:43 PM","1508964180","10585","3536","7049","15","9"
"10/25/17 8:44 PM","1508964240","10594","3539","7055","9","3"
"10/25/17 8:45 PM","1508964300","10609","3544","7065","15","5"
"10/25/17 8:46 PM","1508964360","10624","3549","7075","15","5"
"10/25/17 8:47 PM","1508964420","10637","3554","7083","13","5"
"10/25/17 8:48 PM","1508964480","10648","3558","7090","11","4"
"10/25/17 8:49 PM","1508964540","10657","3560","7097","9","2"
"10/25/17 8:50 PM","1508964600","10683","3573","7110","26","13"
"10/25/17 8:51 PM","1508964660","10707","3581","7126","24","8"
"10/25/17 8:52 PM","1508964720","10715","3582","7133","8","1"
"10/25/17 8:53 PM","1508964780","10732","3586","7146","17","4"
"10/25/17 8:54 PM","1508964840","10753","3592","7161","21","6"
"10/25/17 8:55 PM","1508964900","10771","3600","7171","18","8"
"10/25/17 8:56 PM","1508964960","10782","3607","7175","11","7"
"10/25/17 8:57 PM","1508965020","10795","3614","7181","13","7"
"10/25/17 8:58 PM","1508965080","10806","3620","7186","11","6"
"10/25/17 8:59 PM","1508965140","10821","3624","7197","15","4"
"10/25/17 9:00 PM","1508965200","10847","3636","7211","26","12"
"10/25/17 9:01 PM","1508965260","10853","3638","7215","6","2"
"10/25/17 9:02 PM","1508965320","10870","3649","7221","17","11"
"10/25/17 9:03 PM","1508965380","10891","3657","7234","21","8"
"10/25/17 9:04 PM","1508965440","10904","3665","7239","13","8"
"10/25/17 9:05 PM","1508965500","10927","3672","7255","23","7"
"10/25/17 9:06 PM","1508965560","10952","3693","7259","25","21"
"10/25/17 9:07 PM","1508965620","10962","3699","7263","10","6"
"10/25/17 9:08 PM","1508965680","10973","3703","7270","11","4"
"10/25/17 9:09 PM","1508965740","10989","3706","7283","16","3"
"10/25/17 9:10 PM","1508965800","11000","3711","7289","11","5"
"10/25/17 9:11 PM","1508965860","11015","3716","7299","15","5"
"10/25/17 9:12 PM","1508965920","11034","3721","7313","19","5"
"10/25/17 9:13 PM","1508965980","11046","3729","7317","12","8"
"10/25/17 9:14 PM","1508966040","11058","3732","7326","12","3"
"10/25/17 9:15 PM","1508966100","11068","3739","7329","10","7"
"10/25/17 9:16 PM","1508966160","11086","3751","7335","18","12"
"10/25/17 9:17 PM","1508966220","11093","3753","7340","7","2"
"10/25/17 9:18 PM","1508966280","11121","3767","7354","28","14"
"10/25/17 9:19 PM","1508966340","11132","3776","7356","11","9"
"10/25/17 9:20 PM","1508966400","11148","3786","7362","16","10"
"10/25/17 9:21 PM","1508966460","11180","3802","7378","32","16"
"10/25/17 9:22 PM","1508966520","11200","3813","7387","20","11"
"10/25/17 9:23 PM","1508966580","11220","3824","7396","20","11"
"10/25/17 9:24 PM","1508966640","11238","3837","7401","18","13"
"10/25/17 9:25 PM","1508966700","11257","3848","7409","19","11"
"10/25/17 9:26 PM","1508966760","11282","3860","7422","25","12"
"10/25/17 9:27 PM","1508966820","11310","3869","7441","28","9"
"10/25/17 9:28 PM","1508966880","11341","3886","7455","31","17"
"10/25/17 9:29 PM","1508966940","11376","3910","7466","35","24"
"10/25/17 9:30 PM","1508967000","11402","3929","7473","26","19"
"10/25/17 9:31 PM","1508967060","11426","3940","7486","24","11"
"10/25/17 9:32 PM","1508967120","11446","3951","7495","20","11"
"10/25/17 9:33 PM","1508967180","11471","3967","7504","25","16"
"10/25/17 9:34 PM","1508967240","11489","3973","7516","18","6"
"10/25/17 9:35 PM","1508967300","11530","3987","7543","41","14"
"10/25/17 9:36 PM","1508967360","11565","4011","7554","35","24"
"10/25/17 9:37 PM","1508967420","11586","4024","7562","21","13"
"10/25/17 9:38 PM","1508967480","11613","4039","7574","27","15"
"10/25/17 9:39 PM","1508967540","11659","4065","7594","46","26"
"10/25/17 9:40 PM","1508967600","11696","4087","7609","37","22"
"10/25/17 9:41 PM","1508967660","11728","4110","7618","32","23"
"10/25/17 9:42 PM","1508967720","11772","4134","7638","44","24"
"10/25/17 9:43 PM","1508967780","11795","4146","7649","23","12"
"10/25/17 9:44 PM","1508967840","11828","4170","7658","33","24"
"10/25/17 9:45 PM","1508967900","11852","4184","7668","24","14"
"10/25/17 9:46 PM","1508967960","11870","4189","7681","18","5"
"10/25/17 9:47 PM","1508968020","11885","4193","7692","15","4"
"10/25/17 9:48 PM","1508968080","11910","4199","7711","25","6"
"10/25/17 9:49 PM","1508968140","11927","4208","7719","17","9"
"10/25/17 9:50 PM","1508968200","11947","4218","7729","20","10"
"10/25/17 9:51 PM","1508968260","11960","4225","7735","13","7"
"10/25/17 9:52 PM","1508968320","11975","4229","7746","15","4"
"10/25/17 9:53 PM","1508968380","11992","4238","7754","17","9"
"10/25/17 9:54 PM","1508968440","11999","4244","7755","7","6"
"10/25/17 9:55 PM","1508968500","12003","4244","7759","4","0"
